1111111111
10EP000C11
10V000V001
10V0V0V001
1111111111
